########
########
#      # 
#  @$. # 
#  $ . # 
#      #
########
########

####
# .#
#  ###
# @  #
#  $ #
#  ###
####

  ####
###  ####
#  $    #
# # ### #
# #  @# #
#   .## #
####    #
   ######

######
#    #
# .$ #
##.$###
 #.$  #
 #  @ #
 #  ###
 ####

#######
#. .  #
#.    #
## # ##
# $$$ #
#  @  #
#######

#####
#   #####
# # $ $ #
# ..#   #
## . $ ##
 #  # @#
 #######

 ## #####
## ## . #
# ## $. #
 ## $   #
## $@ ###
# $  ##
#.. ## ##
#   # ##
##### #

####
#  ###
#    #
# $  #
### ###
# $ $ #
#..@..#
#  $  #
###  ##
  ####

#####
#  @####
#  $.  #
###$.# #
#  $.# #
# #$.  #
#    ###
######

   ###
  ## # ####
 ##  ###  #
## $      #
#   @$ #  #
### $###  #
  #  #..  #
 ## ##.# ##
 #      ##
 #     ##
 #######
